1 1 1 1 1 1 1 1 1 1 1 1 1 1 1
1 0 0 0 0 0 0 0 0 0 0 0 0 0 1
1 0 0 0 0 0 0 0 0 0 0 0 0 0 1
1 0 0 0 0 0 0 0 0 0 0 0 0 0 1
1 0 0 0 0 0 0 0 0 0 0 0 0 0 1
1 0 0 0 0 0 0 0 0 0 0 0 0 0 1
1 0 0 0 0 0 0 0 0 0 0 0 0 0 1
1 0 0 0 0 0 0 0 0 0 0 0 0 0 1
1 0 0 0 0 0 0 0 0 0 98 0 0 0 1
1 0 0 0 1 1 1 1 1 1 1 1 0 0 1
1 0 0 0 1 2 98 0 98 2 0 1 0 0 1
1 0 0 0 1 0 0 0 0 0 0 1 0 0 1
1 0 0 0 1 0 0 0 0 0 0 1 0 0 1
1 0 0 2 1 0 0 99 0 0 0 0 0 0 1
1 1 1 1 1 1 1 1 1 1 1 1 1 1 1